WWWWWWWWWWWW
E P W W K  W
W   W W    W
W   W W    W
W   W W    W
W   W W    W
W   W W    W
W   W W    W
W   W W    W
W   WWW    W
W          W
WWWWWWWWWWWW